Z Z Z Z Z Z S I Z Z 
Z Z Z Z Z Z I R Z Z 
I Z Z I I S S S S Z 
I I I S S S S S S S 
I I I Z S S S S Z I 
Z Z Z Z Z I Z I R Z 
Z Z Z Z R Z Z I Z Z 
Z Z Z Z Z Z Z I Z Z 
Z Z Z Z Z Z Z R Z Z 
Z Z Z Z Z Z S I Z Z 
