Z S S I Z Z Z Z Z Z 
Z I S I Z Z Z Z Z Z 
Z I S I Z Z Z Z Z Z 
Z R S S Z Z Z Z Z Z 
I I S S Z I R Z I I 
S S S S S S S S S S 
S S S S S S S S S S 
S S S S S I I I S S 
S S S I Z I Z Z Z I 
I S S I Z Z Z Z Z Z 
