Z Z Z Z Z Z S S Z Z 
Z Z Z Z I I I S R Z 
S Z I I S S S S S I 
S S S S S S S S S S 
I S I I S S S S I I 
Z Z Z Z Z S Z S R Z 
Z Z Z Z R Z Z I Z Z 
Z Z Z Z Z Z I I I Z 
Z Z Z Z Z Z Z R I Z 
Z Z Z Z Z Z S I Z Z 
