Z I S Z Z Z Z Z Z Z 
I I S Z S I S Z I I 
S S S S S S S S S S 
I S S S I I S I S I 
Z Z S S S Z Z Z I Z 
Z Z S S Z Z Z Z Z Z 
Z I S S Z Z Z Z Z Z 
Z Z S I Z Z Z Z Z Z 
Z I S I Z Z Z Z Z Z 
Z I S Z Z Z Z Z Z Z 
