Z Z I Z Z Z Z Z Z Z 
Z Z Z Z Z Z I Z Z Z 
I I S I Z I I I I I 
Z I I S Z Z I Z Z Z 
Z Z Z Z I Z Z Z Z Z 
Z Z Z Z Z Z Z Z Z Z 
Z Z Z Z Z Z Z Z Z Z 
Z Z Z Z Z Z Z Z Z Z 
Z Z Z Z Z Z Z Z Z Z 
Z Z Z Z Z Z Z Z Z Z 
