Z Z Z Z Z Z S S I Z 
Z Z Z Z S S S S S I 
S I S S S S S S S S 
S S S S S S S S S S 
S S S S S S S S S S 
I I I I Z S I S S Z 
Z Z Z Z R Z I S I Z 
Z Z Z Z Z Z S S S Z 
Z Z Z Z Z Z I S S Z 
Z Z Z Z Z I S S I Z 
