S S S I I I I S S S 
S S S S S S S S S S 
S S S S S S S S S S 
S S S S I S R S S S 
S I Z R I Z S S S S 
R I Z Z Z Z I S S S 
I Z Z Z Z Z S S S S 
S Z Z Z Z Z S S S S 
S Z Z R Z Z R S S S 
S Z I Z Z Z S S S S 
