I S S S S S S S S S 
S S S S S S S S S S 
S S S S S S S S S S 
S S S S S S S S S S 
S S S S S S S S S S 
S S S S S S S S S S 
S S S S S S S S S S 
R I R Z I S S S S S 
S Z Z Z I S S S S S 
S Z I Z I S S S S S 
