Z Z Z Z Z Z Z Z Z Z 
I Z Z Z Z Z Z Z Z Z 
Z I Z Z Z Z Z Z Z Z 
I Z I Z Z I I I I S 
I Z Z Z Z I Z Z Z S 
I Z Z Z Z Z Z Z Z Z 
Z Z Z Z Z Z Z Z Z Z 
Z Z Z Z Z Z Z Z Z Z 
Z Z Z Z Z Z Z Z Z Z 
Z Z Z Z Z Z Z Z Z Z 
