Z Z Z Z Z Z Z Z Z Z 
Z Z Z Z Z Z Z Z S Z 
Z Z Z Z Z Z Z S I Z 
Z Z Z Z Z Z R Z I Z 
Z Z Z Z Z Z Z Z I Z 
Z Z Z Z Z Z Z Z Z Z 
Z Z Z Z Z Z Z Z Z Z 
Z Z Z Z Z Z Z Z I Z 
Z Z Z Z Z Z Z Z Z R 
Z Z Z Z Z Z Z Z Z Z 
