S S S S S S Z Z S S 
S S S S S S Z Z Z S 
S S S S S S Z Z Z S 
S S S S S S S S S S 
S S S S S S S S S S 
S S S S S S S S S S 
S S S S S S S S S S 
S S S S S S S S S S 
S S S S S S S S S S 
S S S S S S S S S S 
