Z I S Z Z Z Z Z Z Z 
Z I I Z I Z S Z Z Z 
S S S S I S S S S S 
I S S S I I S Z I I 
Z Z I I S Z Z Z Z Z 
Z Z I I Z Z Z Z Z Z 
Z Z I I Z Z Z Z Z Z 
Z Z I Z Z Z Z Z Z Z 
Z Z I Z Z Z Z Z Z Z 
Z I I Z Z Z Z Z Z Z 
