Z Z Z Z Z Z I Z Z Z 
Z Z Z Z Z Z Z R Z Z 
Z Z Z Z Z I R S I Z 
Z Z Z I I S S I R I 
Z Z Z Z I I S I Z Z 
Z Z Z Z Z Z Z Z Z Z 
Z Z Z Z R Z Z Z Z Z 
Z Z Z Z Z Z Z Z Z Z 
Z Z Z Z Z Z Z Z Z Z 
Z Z Z Z Z Z I Z Z Z 
