I I I S S S S S S S 
S S S S S S S S S S 
I S I S I S S S I I 
Z Z Z Z S I S S R Z 
Z Z Z Z Z S S S Z I 
Z Z Z Z Z I S S I Z 
Z Z Z Z Z S S I S Z 
Z Z Z Z R S S S Z Z 
R Z Z Z Z S S S Z Z 
Z Z R I R I S S S I 
