S S S S S S S S S S 
S S S S S S S S S S 
S S S S S S S S S S 
S S S S S S S S S S 
I S S S S S S S S S 
R Z I I S S S S S S 
I Z Z S S S S S S S 
I I Z S S S S S S S 
S S S S S S S S S S 
S S S S S S S S S S 
