S S S S S S S S S S 
S I I I S S S S S S 
Z Z Z Z Z I S S I I 
Z Z Z Z Z Z I S Z Z 
Z Z Z Z Z Z I S Z Z 
Z Z Z Z Z Z S S Z Z 
Z Z Z Z Z Z Z S Z Z 
Z Z Z Z Z I I S Z Z 
Z Z Z Z Z Z S S I Z 
I I S I S S S S S I 
