Z I Z Z Z Z Z Z S S 
I I I Z I I I S S R 
S S I I S I S S S S 
Z Z Z Z Z R R S S S 
Z Z Z Z Z Z Z I S I 
Z Z Z Z Z Z Z S S S 
Z Z Z Z Z Z Z I S I 
I Z Z Z Z Z I S S I 
Z Z Z Z Z Z Z S S R 
Z Z Z Z Z Z Z Z S I 
