S S S S S S S S S S 
S S S S S S S S S S 
S S S S S S S S S S 
S S S S S S S S S S 
S S S S S S S S S S 
R Z S S S S S S S S 
I Z Z S S S S S S S 
S I R S S S S S S S 
S S S S S S S S S S 
S S S S S S S S S S 
