Z I I Z Z Z Z Z Z Z 
Z Z I Z Z Z Z Z Z Z 
Z Z I Z Z Z Z Z Z Z 
Z Z I Z Z Z Z Z Z Z 
Z Z I Z Z Z R Z Z Z 
I I I R Z Z Z I Z Z 
S S S S I I I I I S 
R S I Z I Z Z Z Z Z 
R Z Z Z Z Z Z Z Z Z 
Z I I Z Z Z Z Z Z Z 
