S S S S S S S S S S 
S S S S S S S S S S 
S S S S S S S S S S 
S S S S S S S S S S 
S S S S S S S S S S 
S S I I I S S S S S 
S S Z Z Z S S S S S 
S S Z Z Z S S S S S 
S S I R Z S S S S S 
S S S S I I S S S S 
