S S S S S S S S S S 
S S S S S S S S S S 
S S S S S S S S S S 
S S S S S S S S S S 
S S S S S S S S S S 
S S S S S S S S S S 
S S I I Z S S S S S 
S S I Z I S S S S S 
S S S R R S S S S S 
S S S S S S S S S S 
