Z S S I Z Z Z Z Z Z 
I S S I S I S I I I 
S S S S S S S S S S 
S S S S S S S I S S 
I I S S S Z Z I I Z 
Z I S S I Z Z Z Z Z 
Z I S S Z Z Z Z Z Z 
Z I S I Z Z Z Z Z Z 
Z I S I Z Z Z Z Z Z 
Z S S I Z Z Z Z Z Z 
