Z Z Z Z Z Z Z Z Z I 
Z Z Z Z Z Z Z R S R 
Z I Z Z I Z I S S I 
Z Z Z Z Z Z R I S Z 
Z Z Z Z Z Z Z Z S Z 
Z Z Z Z Z Z Z I I Z 
Z Z Z Z Z Z Z Z I Z 
Z Z Z Z Z Z Z Z I Z 
Z Z Z Z Z Z Z Z I R 
Z Z Z Z Z Z Z Z Z Z 
