Z Z S Z Z Z Z Z Z Z 
Z Z I Z I Z S Z Z Z 
I S S I I S S S I I 
Z S S S Z Z S Z I Z 
Z Z I I I Z Z Z Z Z 
Z Z I I Z Z Z Z Z Z 
Z Z I I Z Z Z Z Z Z 
Z Z I Z Z Z Z Z Z Z 
Z Z I Z Z Z Z Z Z Z 
Z Z I Z Z Z Z Z Z Z 
