Z Z Z Z Z Z Z I I Z 
Z Z Z Z Z S R I Z Z 
Z Z Z Z Z Z Z Z Z Z 
Z Z Z Z Z Z Z Z Z Z 
Z Z Z Z Z Z Z Z Z Z 
Z Z Z Z Z Z Z Z Z Z 
Z Z Z Z Z Z Z Z Z Z 
Z Z Z Z Z Z I Z Z Z 
R Z Z Z Z Z Z Z Z Z 
Z Z Z Z Z Z Z Z Z Z 
