S S Z Z Z Z Z Z Z Z 
S S S I Z I Z Z Z I 
S S S I I I I S I S 
S S S S S S S S S S 
S I Z I I S I I I S 
S I Z Z Z Z Z Z S I 
S Z Z Z Z Z Z Z Z I 
S I Z Z Z Z Z Z Z Z 
S Z Z Z Z Z Z Z Z I 
S I Z Z Z Z Z Z Z Z 
