S S S S S S S S S S 
S S S S S S S S S S 
S S S S S S S S S S 
S S S S S S S S S S 
S S S S S S S S S S 
S S S S S S S S S S 
S S S S S S S S S S 
S S S S I I I S S S 
S S S S I Z S S S S 
S S S S S S I S S S 
