S S S S S S S S S S 
S S S S S S S S S S 
S S S S S S S S S S 
S Z Z Z S S S S S S 
Z I Z Z Z S S S S S 
S Z Z Z Z S S S S S 
Z Z Z Z I S S S S S 
I Z I Z I S S S S S 
S S S S S S S S S S 
S S S S S S S S S S 
