S S S S S S S S S S 
S S S S S S S S S S 
S S S S S S S S S S 
S S S S S S S S S S 
I S I S S S S S S S 
R Z I I S S S S S S 
Z Z Z I S S S S S S 
I Z Z R S S S S S S 
S I S S S S S S S S 
S S S S S S S S S S 
