I S S S I Z Z Z Z Z 
I S S S I Z Z Z Z Z 
I S S S I Z Z Z Z Z 
I S S S I Z Z Z Z Z 
S S S S I S R I S S 
S S S S S S S S S S 
S S S S S S S S S S 
S S S S S S S S S S 
S S S S I S I I I S 
S S S S I Z Z Z Z I 
