R R R R R R R Z R R 
R R Z R R R Z Z R Z 
Z R R Z R Z Z R Z R 
R R R R R R R Z R R 
R Z R R Z R R R R R 
R R R R R R R R Z R 
R R R R R R Z R R R 
Z R R R R R R R Z R 
R R R R R R Z R R Z 
R R R R Z Z R Z Z R 
