Z Z Z Z Z Z Z Z Z Z 
Z Z Z Z Z Z Z Z Z Z 
Z Z Z Z Z Z Z Z Z Z 
Z Z Z Z Z Z Z Z Z Z 
Z Z Z Z Z Z Z Z Z Z 
Z Z Z Z Z Z Z Z Z Z 
S S I I I Z I I Z I 
Z I Z Z Z Z Z Z Z Z 
R Z Z Z Z Z Z Z Z Z 
Z Z Z Z Z Z Z Z Z Z 
