S S S S S S S S S S 
S S S S S S S S S S 
S I Z I I S S S S S 
Z Z Z Z S I S S S Z 
Z Z Z Z Z I S S S Z 
Z Z Z Z Z I S S S Z 
Z Z Z Z Z Z S S S Z 
Z Z Z Z Z S S S S Z 
I I Z Z S S S S S S 
S S S S S S S S S S 
