S S S S S S S S S S 
S S S S S S S S S S 
S S S S S S S S S S 
S S S S S S S S S S 
S S S S S S S S S S 
R I S S S S S S S S 
S Z I S S S S S S S 
S S R S S S S S S S 
S S S S S S S S S S 
S S S S S S S S S S 
