S S S S S S S S S S 
S S S S S S S S S S 
S S S S S S S S S S 
S I S I S S S S S I 
Z I Z I I S S S S S 
Z Z Z Z S S S S S Z 
Z Z Z Z I S S S S I 
Z Z Z Z S S S S S Z 
R Z I Z R S S S S I 
S R S S S S S S S S 
