I S S I Z I Z Z Z Z 
S S S I S S S I S S 
S S S S S S S S S S 
S S S S S S S S S S 
I I S S S Z Z I S I 
Z I S S I Z Z Z Z Z 
Z S S S I Z Z Z Z Z 
Z I S S I Z Z Z Z Z 
Z S S S Z Z Z Z Z Z 
I S S I Z Z Z Z Z Z 
