Z Z Z Z Z Z Z Z Z Z 
Z Z Z Z Z Z Z Z Z Z 
Z Z Z Z Z Z R I Z Z 
Z Z Z Z Z I S Z R Z 
Z Z Z Z Z Z I Z Z Z 
Z Z Z Z Z Z Z Z Z Z 
Z Z Z Z R Z Z Z Z Z 
Z Z Z Z Z Z Z Z Z Z 
Z Z Z Z Z Z Z Z Z Z 
Z Z Z Z Z Z Z Z Z Z 
