S S S S S S S S S S 
S S S S S S S S S S 
S S S S S S S S S S 
I Z I I S S S S S Z 
Z Z Z I Z S S S I S 
Z Z Z Z I S S S S Z 
Z Z Z Z Z S S S S I 
Z Z Z Z R S S S R Z 
R Z Z Z Z S S S I I 
I Z S S S S S S S S 
