Z I I Z Z Z Z Z Z Z 
Z Z I Z Z Z Z Z Z Z 
Z Z I Z Z Z Z Z Z Z 
Z Z I Z Z Z Z Z Z Z 
Z Z I Z Z Z R Z Z Z 
I I I R Z Z Z I Z I 
S S S S S I S S I S 
R S I Z I Z Z Z Z I 
R R R Z Z Z Z Z Z Z 
Z I I Z Z Z Z Z Z Z 
