S S S S S S S S S S 
S S S S S S S S S S 
S S S S S S S S S S 
S I S S S S S S S I 
Z I Z S I S S S S S 
Z Z Z Z S S S S S I 
Z Z Z Z I S S S S S 
Z Z Z Z S S S S S I 
S Z I I S S S S S S 
S S S S S S S S S S 
