Z Z Z Z Z Z Z Z Z Z 
Z Z Z Z Z Z Z Z Z Z 
Z S S Z Z Z Z Z Z Z 
Z Z Z S Z Z Z Z Z Z 
Z S S Z Z Z Z Z Z Z 
S Z Z Z S Z Z Z Z Z 
Z S S S Z Z Z Z Z Z 
Z Z S S Z Z Z Z Z Z 
Z S S S S Z Z Z Z Z 
Z Z Z Z S Z Z Z Z Z 
