Z Z Z Z Z Z Z Z Z Z 
Z Z Z Z Z Z Z Z Z Z 
Z Z Z Z Z Z Z Z Z Z 
Z Z Z Z Z Z Z Z Z Z 
Z Z Z Z Z Z Z Z Z Z 
Z Z Z Z Z Z Z Z Z Z 
S I I I Z Z Z Z Z I 
Z I Z Z Z Z Z Z Z Z 
R Z Z Z Z Z Z Z Z Z 
Z Z Z Z Z Z Z Z Z Z 
