I S I I Z I Z S S S 
S S S S S S S S S S 
S S S S S S S S S S 
S S I S I S R S S S 
S Z Z R Z Z I S S S 
R Z Z Z Z Z I S S S 
I Z Z Z Z Z I S S S 
S Z Z Z Z Z S S S S 
I Z Z Z Z Z R S S S 
I Z Z Z Z Z S S S S 
