S S S S I Z Z Z Z Z 
S S S S I Z Z Z Z Z 
I S S S I Z Z Z Z Z 
I S S S I Z Z Z Z I 
S S S S I S S I S S 
S S S S S S S S S S 
S S S S S S S S S S 
S S S S S S S S S S 
S S S S S S I I S S 
S S S S I Z Z Z R S 
