S S S I Z Z Z Z I S 
S S S S I S S S S S 
S S S S S S S S S S 
S S S S S S S S S S 
S S S S S S S S S S 
S S I S I S I I S S 
S S I Z Z Z Z Z I S 
S S I Z Z Z Z I S S 
S S S Z Z Z Z Z I S 
S S S Z Z Z Z Z I S 
