S S S S S S S S S S 
S S S S S S S S S S 
S S S S S S S S S S 
S S S S S S S S S S 
S S S S S S S S S S 
S S S S S S S S S S 
S S S S S S I S I S 
S S S S S S I Z S S 
S S S S S S I S I S 
S S S S S S S S S S 
