Z I Z S S S S S S S 
S S S S S S S S S S 
I I Z I I S S S Z Z 
Z Z Z Z R Z S I Z Z 
Z Z Z Z Z I S I Z Z 
Z Z Z Z Z Z S S I Z 
Z Z Z Z Z S S I I Z 
Z Z Z Z R S S S Z Z 
R Z Z Z Z S S S Z Z 
Z Z R I Z Z S R I I 
