Z Z Z Z Z Z S S I Z 
Z Z Z Z I I S S R I 
S I I S S S S S S I 
S S S S S S S S S S 
S S S I S S S S I S 
Z Z Z Z Z S I S R Z 
Z Z Z Z R Z I S Z Z 
Z Z Z Z Z Z I S I Z 
Z Z Z Z Z Z I S I Z 
Z Z Z Z Z Z S S Z Z 
