Z Z Z Z Z Z I Z Z Z 
Z Z Z Z Z Z Z Z Z Z 
Z Z Z Z Z I R S Z Z 
Z Z Z I Z S S Z R Z 
Z Z Z Z Z Z I Z Z Z 
Z Z Z Z Z Z Z Z Z Z 
Z Z Z Z R Z Z Z Z Z 
Z Z Z Z Z Z Z Z Z Z 
Z Z Z Z Z Z Z Z Z Z 
Z Z Z Z Z Z Z Z Z Z 
