S S S S S S S S S S 
S S S S S S S S S S 
S S S S S S S S S S 
S S S S S S S S S S 
S S S S S S S S S S 
S S S S S S S S S S 
S S S I I S S S S S 
S S I Z S S S S S S 
S S S S R S S S S S 
S S S S S S S S S S 
