Z I Z Z Z Z Z Z I S 
I I Z Z Z Z Z R S R 
I S I Z S Z S S S S 
Z Z Z Z Z R R S S I 
Z Z Z Z Z Z Z I S I 
Z Z Z Z Z Z Z S S I 
Z Z Z Z Z Z Z Z S Z 
Z Z Z Z Z Z I I S Z 
Z Z Z Z Z Z Z I S R 
Z Z Z Z Z Z Z Z I I 
