Z I Z Z Z I S S S I 
I I I I S S S S S S 
S S S S S S S S S S 
S S S S S S S S S S 
S S S S S S S S S S 
S S S S R S S S S S 
Z Z Z Z R I S S S I 
Z Z Z Z Z I S S S Z 
Z Z Z Z Z I S S S Z 
Z Z Z Z Z S S S S Z 
