S S S S S S S S S S 
S S S S S S S S S S 
S S I S S S S S S S 
I Z Z Z S S S S S I 
Z I Z Z Z S S S S I 
I Z Z Z Z S S S S I 
Z Z Z Z I I S S S I 
I Z I Z I S S S S I 
S S I I S S S S S S 
S S S S S S S S S S 
