Z Z Z Z Z I Z S S I 
Z Z Z I I S S I Z Z 
Z Z Z Z Z Z Z I Z Z 
Z Z Z Z Z Z Z Z Z Z 
Z Z Z Z Z Z Z Z Z Z 
Z Z Z Z Z Z Z I Z Z 
Z Z Z Z Z Z Z Z Z Z 
Z Z Z Z Z I S Z Z Z 
R Z Z Z Z Z Z Z Z Z 
Z Z Z Z Z Z Z Z Z Z 
