S S S S S S S S S S 
S S S S S S S S S S 
S S S S S S S S S S 
S S S S S S S S S S 
S S S S S S S S S S 
S S S S S S S S S S 
S S S S S S Z I Z S 
S S S S S S Z Z I S 
S S S S S S Z I Z S 
S S S S S S S S S S 
