S S S S S S S S S S 
I Z Z Z S S S S S S 
Z Z Z Z Z Z S I Z I 
Z Z Z Z Z Z I I Z Z 
Z Z Z Z Z Z I I Z Z 
Z Z Z Z Z Z I I Z Z 
Z Z Z Z Z Z Z I Z Z 
Z Z Z Z Z I Z I Z Z 
Z Z Z Z Z Z S I I Z 
Z I I Z I I S S I I 
