S S S S S Z Z Z Z R 
S S S S S Z Z Z Z I 
S S S S S R Z Z Z Z 
S S S S S Z I Z I I 
S S S S S S S S S S 
S S S S S S S S S S 
S S S S S S S S S S 
S S S S S S S S S S 
S S S S S S S S S S 
S S S S S Z Z R R S 
