Z Z Z Z Z Z Z Z Z Z 
Z Z Z Z Z Z Z Z I Z 
Z Z Z Z Z Z Z I I Z 
Z Z Z Z Z Z R Z I Z 
Z Z Z Z Z Z Z Z I Z 
Z Z Z Z Z Z Z Z Z Z 
Z Z Z Z Z Z Z Z Z Z 
Z Z Z Z Z Z Z Z Z Z 
Z Z Z Z Z Z Z Z Z Z 
Z Z Z Z Z Z Z Z Z Z 
