Z Z Z I I I I S S I 
I I I I I S S S I Z 
Z Z Z Z Z I I I Z Z 
Z Z Z Z Z Z I Z Z Z 
Z Z Z Z Z Z I Z Z Z 
Z Z Z Z Z Z I I Z Z 
Z Z Z Z Z I I Z Z Z 
Z Z Z Z Z I S I Z Z 
R Z Z Z Z I I I Z Z 
Z Z Z Z Z Z I R Z Z 
