S S S S S S S S S S 
S S S S S S S S S S 
I Z Z Z Z S S S S S 
Z Z Z Z I Z S S I Z 
Z Z Z Z Z Z S S I Z 
Z Z Z Z Z Z S S I Z 
Z Z Z Z Z Z I S I Z 
Z Z Z Z Z S S S I Z 
Z Z Z Z I I S S S I 
S S S S S S S S S S 
