S S S S S S S S S S 
S I I I S S S S S S 
I Z Z Z Z I S S I S 
Z Z Z Z I Z S S I Z 
Z Z Z Z Z Z S S I Z 
Z Z Z Z Z Z S S I Z 
Z Z Z Z Z Z I S I Z 
Z Z Z Z Z S I S I Z 
Z Z Z Z I I S S S I 
I S S I S S S S S S 
