Z I Z Z Z Z Z Z Z Z 
S Z Z Z Z Z Z Z Z Z 
I S I Z Z Z Z Z Z Z 
I Z I I I I I I I S 
I Z Z Z Z I Z Z Z S 
S Z Z Z Z Z Z Z I Z 
Z Z Z Z Z Z Z Z Z Z 
I Z Z Z Z Z Z Z Z Z 
Z Z Z Z Z Z Z Z Z Z 
Z Z Z Z Z Z Z Z Z Z 
