Z Z I Z Z Z Z Z Z Z 
Z Z Z Z Z Z I Z Z Z 
Z I I Z Z I I I Z Z 
Z I I I Z Z I Z Z Z 
Z Z Z Z Z Z Z Z Z Z 
Z Z Z Z Z Z Z Z Z Z 
Z Z Z Z Z Z Z Z Z Z 
Z Z Z Z Z Z Z Z Z Z 
Z Z Z Z Z Z Z Z Z Z 
Z Z Z Z Z Z Z Z Z Z 
