S S S S S S S S S S 
S S S S S S S S S S 
S S S S S S S S S S 
S S S S S S S S S S 
S S S S S S S S S S 
S S S S S S S S S S 
S S S S S S S S S S 
S I R I S S S S S S 
S Z Z Z S S S S S S 
S Z I I S S S S S S 
