S S S S S S S S S S 
S S S S S S S S S S 
S S S S S S S S S S 
S S S S S S S S S S 
Z S I S S S S S S S 
Z Z Z Z S S S S S I 
Z Z Z I S S S S S S 
Z Z Z Z S S S S S I 
S I S I S S S S S S 
S S S S S S S S S S 
