Z Z S S S S Z Z Z Z 
S S S S S S Z Z Z Z 
Z S S S Z S Z Z Z Z 
S S S S S Z Z Z Z Z 
Z S S S Z S Z Z Z Z 
S S S S S S S Z S Z 
S S S S S S S S S S 
S S S S S S S S Z S 
S S S S S S Z Z Z Z 
Z S S S S Z Z Z Z Z 
