Z Z Z Z Z Z Z Z I I 
Z Z Z Z Z Z Z R S R 
I I Z Z I Z I S S I 
Z Z Z Z Z R R I S I 
Z Z Z Z Z Z Z Z S Z 
Z Z Z Z Z Z Z I I I 
Z Z Z Z Z Z Z Z I Z 
Z Z Z Z Z Z Z I S Z 
Z Z Z Z Z Z Z I I R 
Z Z Z Z Z Z Z Z I Z 
