S S S I I Z Z Z I S 
S S S S S S S S S S 
S S S S S S S S S S 
S S S S S S S S S S 
S S S S S S S S S S 
S S I S S S S S S S 
S S S Z Z I Z Z S S 
S S I Z Z Z Z S S S 
S S S I Z Z Z Z I S 
S S S I Z Z Z Z I S 
