Z S I I I S S S S S 
S S S S S S S S S S 
S S S S S S S S S S 
S S S S S S S S S S 
S S S S S S S S S S 
S S S S S S S S S S 
I I I I R S S S S S 
Z Z Z Z Z S S S S I 
I Z Z Z Z S S S S I 
I Z Z Z Z S S S S S 
