S S S S I S I S S S 
S S S S S S S S S S 
S S S S S S S S S S 
S S S S S S S S S S 
S I I R I Z S S S S 
S I Z Z Z Z S S S S 
S Z Z Z Z I S S S S 
S I Z Z Z I S S S S 
S I Z R Z Z S S S S 
S I I Z Z Z S S S S 
