I S S S Z Z Z Z Z Z 
I S S S Z Z Z Z Z Z 
Z S S S Z Z Z Z Z Z 
Z S S S Z Z Z Z Z Z 
I S S S Z I R Z S I 
S S S S S S S S S S 
S S S S S S S S S S 
S S S S S S S S S S 
S S S S I I Z Z I I 
I S S S Z Z Z Z Z I 
