Z Z Z Z Z Z S S S I 
I Z I I S S S S S S 
S S S S S S S S S S 
S S S S S S S S S S 
S S S S S S S S S S 
I I I I R S S S S R 
Z Z Z Z R Z S S I I 
Z Z Z Z Z Z S S S Z 
Z Z Z Z Z Z S S S Z 
Z Z Z Z Z I S S I Z 
