I S I S S S S S S S 
S S S S S S S S S S 
S S S S S S S S S S 
S S S S S S S S S S 
S S S S S S S S S S 
S S S S S S S S S S 
S S I I S S S S S S 
Z Z R Z I S S S S S 
S Z Z Z I S S S S S 
I Z Z Z I S S S S S 
