I I Z Z Z Z Z Z Z Z 
S I I Z Z Z Z Z Z Z 
I S I Z Z Z Z I Z I 
S I S I I S S S S S 
S Z Z Z Z S Z Z Z S 
S Z Z Z Z Z Z Z I Z 
I Z Z Z Z Z Z Z Z Z 
I Z Z Z Z Z Z Z Z Z 
I Z Z Z Z Z Z Z Z Z 
I Z Z Z Z Z Z Z Z Z 
