S S S S S I I I S S 
S S S S S S S S S S 
S S S S S S S S S S 
S S S S S S S S S S 
S S S S S S S S S S 
S S S S S S S S S S 
S S S I I S I I S S 
S S S I Z Z Z S S S 
S S S S Z Z Z I S S 
S S S S I Z Z I S S 
