Z Z Z Z Z Z S I Z Z 
Z Z Z Z Z Z Z R Z Z 
I Z Z Z I S R S I Z 
I I I S I S S I S I 
Z I Z Z I I S I Z Z 
Z Z Z Z Z I Z I R Z 
Z Z Z Z R Z Z Z Z Z 
Z Z Z Z Z Z Z Z Z Z 
Z Z Z Z Z Z Z Z Z Z 
Z Z Z Z Z Z I Z Z Z 
