S S S S S S S S S S 
S S S S S S S S S S 
S S S S S S S S S S 
S S S S S S S S S S 
S S I I S S S S S S 
S I Z I S S S S S S 
S I I I S S S S S S 
S S S S S S S S S S 
S S S S S S S S S S 
S S S S S S S S S S 
