I S I S S S S S S S 
S S S S S S S S S S 
S S I S S S S S I I 
I Z I Z S I S S R Z 
Z Z Z Z Z S S S I I 
Z Z Z Z I I S S S Z 
Z Z Z Z Z S S S S Z 
Z Z Z Z R S S S Z Z 
R Z Z Z Z S S S I Z 
I Z R S R I S S S S 
