I S I Z Z Z Z I S S 
S S S I S S S S S S 
S S S S S S S S S S 
I I I I Z R R S S S 
I Z Z Z Z Z I S S S 
R Z Z Z Z Z Z S S S 
Z Z Z Z Z Z I S S S 
S Z Z Z Z Z S S S S 
I Z Z Z Z Z R S S S 
I Z Z Z Z Z I I S S 
