S S I Z Z Z Z Z Z I 
S S S S Z S I I I S 
S S S S S S S S S S 
S S S S S S S S S S 
S S I S S S S S S S 
S S Z I Z I Z Z S S 
S I Z Z Z Z Z Z Z S 
S S Z Z Z Z Z Z I I 
S I I Z Z Z Z Z Z S 
S S I Z Z Z Z Z Z I 
