Z Z Z Z Z Z Z I I Z 
Z Z Z Z Z I R Z Z Z 
Z Z Z Z Z Z Z Z Z Z 
Z Z Z Z Z Z Z Z Z Z 
Z Z Z Z Z Z Z Z Z Z 
Z Z Z Z Z Z Z Z Z Z 
Z Z Z Z Z Z Z Z Z Z 
Z Z Z Z Z Z I Z Z Z 
R Z Z Z Z Z Z Z Z Z 
Z Z Z Z Z Z Z Z Z Z 
