I S S S Z I I Z Z I 
S S S S S S S S S S 
S S S S S S S S S S 
S S S S S S S S S S 
S S S S S I I S S I 
Z S S S S Z Z Z Z Z 
Z S S S I Z Z Z Z Z 
I S S S I Z Z Z Z Z 
I S S S I Z Z Z Z Z 
I S S S Z Z Z Z Z Z 
