Z S Z Z Z Z Z I S S 
S S I I I I I S S S 
S S S I S I S S S S 
I I Z I Z R R S S S 
I Z Z Z Z Z Z S S S 
Z Z Z Z Z Z Z S S S 
Z Z Z Z Z Z Z I S I 
I Z Z Z Z Z S S S I 
Z Z Z Z Z Z Z S S S 
Z Z Z Z Z Z I I S S 
