I S Z Z Z Z Z Z Z Z 
S I I Z Z Z Z Z Z Z 
S S S Z Z I I I I I 
S I S S S S S S S S 
S I Z I I S Z I I S 
S I Z Z Z Z Z Z S I 
I Z Z Z Z Z Z Z Z Z 
S Z Z Z Z Z Z Z Z Z 
I Z Z Z Z Z Z Z Z Z 
I I Z Z Z Z Z Z Z Z 
